1111111111111111111111111111111111
1E0000000000000C000000000000000001
1010010100100000101001C00000010101
1C00010010101010001001000000010101
1000000000C000000P0000000000000001
1111111111111111111111111111111111