1111111111111111111111111111111111
1CE00P0000000010000000000000000011
1010010100100000101001100000010101
1000010010101010001001000000010101
1000000000100000000000000110000001
1000000000000010000000100000100001
1010010100100000101001100000110101
1100010010101010001001000000010101
1000000000100000010000000000000001
1111111111111111111111111111111111